1 10
##################
#  ##   P#       #
#   #    #       #
#     #  #       #
#                #
#               ##
#   #   ####  #  #
#   #         #  #
#   #      #  ####
#   #      #     #
#             ####
#                #
#######       ## #
#       ##       #
#        #    #  #
#     #####   # ##
#        #    #  #
##################