4 10
##################
#             #  #
#    P        ####
#                #
#  ###     ##   ##
#    #      #    #
#    #      #    #
#    #    ########
#    #      #    #
#    #      #    #
#    #           #
###########      #
#   #        #####
#   #   #        #
#                #
#   #   ###   #  #
#   #         #  #
##################