6 10
##################
#  ## ##   #     #
#  ##  #   ####  #
#          #     #
#   ##   ###  ## #
#                #
#   ###       #  #
#          #  #  #
#    #     #     #
#    #   ###   ###
#                #
#    #     #  ####
#  ###     #     #
#          #   ###
# #        #     #
###     ##########
#               P#
##################