3 4
################
#P             #
#              #
#              #
#              #
#              #
#              #
################