17 2
################
#              #
#       ########
#              #
#              #
#####          #
#              #
#              #
#              #
#              #
#              #
#      #########
#              #
#      #       #
#      #      P#
################